53	87	65	39	04	31	42	20
87	87	65	39	04	31	56	07
87	39	39	39	04	31	56	07
39	53	39	39	04	31	42	07
39	39	39	39	04	31	42	32
39	39	39	39	04	31	42	92
53	39	39	39	04	31	92	66
39	53	48	65	04	55	43	43